X0B0000HH00000C
00B00000000000C
00B00000000000C
00B00000000000C
00B00000000000C
00B00000000000C
00B00000000000C
00B00000000000C
00B00000000000C
00B00000000000C
00B00000000000C
00B00000000000C
00B00000000000C
00B00000000000C
00B000TT0000002