111111111
1X0000001
10000P001
1000000Y1
10P000001
100000001
111111111