1111111111111111
1X00000000000D01
1000000000000001
1000000000000001
1000000000000D01
1M00000000000001
1000000000000001
1000000000000001
1000000C0000S001
1000000000000001
1000000000000001
1B000000000B0001
1000000000000001
10M0000000000201
1111111111111111