111111111111111
1X0000000000001
111111111111101
100000000000001
101111111111111
100000000000001
111111111111101
100000000000001
101111111111111
100000000000001
111111111111101
100000000000001
101111111111111
1000000000YYY21
111111111111111