11111111111111111111
1X000000000000000001
100000000000000Y0001
10001111111111110001
100000000000Y0000001
10000000000000000001
11111111111100000001
100YY000000000000001
10000000000000000001
10000Y00011111111111
10000000000000000001
10000000000000000001
10000000010101010101
10000000000000000001
10101010100000000001
100000YY000000000001
10001111111111110001
10000000000YY0000001
11111111111111100021
11111111111111111111