11111111111111111111
1X000000000000000001
1000S0000000000Y0001
10001111111111110001
100000000000Y0000001
10000000P00000000001
10001111111111110001
10001111111111110001
100000000000000D0001
10000Y00H0000S000001
10000000000000000001
100P00000000000000R1
10011110000011111101
10000000000000000001
10000000000000000001
10001111111111110B01
10001111111111110001
10000000000YY0000001
1C000000000000000021
11111111111111111111