11111111111111111111
1X000F1Y0000C00000Y1
10000O1Y000E00E000Y1
100Z0N1Y0000001100Y1
1011111YE00000E000Y1
10001YY00000010000Y1
1000000E0000E00000Y1
100011111001111100Y1
10000000000E000000Y1
100000100001000000Y1
100000000000E10000Y1
100011001E000E0000Y1
100111100000111111Y1
100011000000000000Y1
10000000001000000BY1
100010000E1111000HY1
10000001000000000HY1
100000E0000000000HY1
100001100000000002Y1
11111111111111111111