11111111111111111111
1X00T0000000000D00C1
10000000000000000001
100B1111111111110001
100000E00000Y0000001
100S000000000Z000001
1111111111110000P001
100YY000000000000001
100000000000000M0001
10000G00011111111111
10000OF0M00000000001
10000000000000000001
10011110000011111101
1P000000000M000000H1
101111111000000S00R1
10M00N0G000000000001
10001111111111110001
10000S00000YY000D001
11111111111111100021
11111111111111111111